Accident - something bad which happens that is not expected or intended, and which causes injury or damage
Across - from one side of something to the other
Bad - of low quality and not acceptable
Before - earlier than the time when something happens
Blood - the red liquid that flows around your body
Carpet - thick material for covering floors, often made of wool
Ceiling - the surface of a room which you can see when you look above you
Check - to examine something to make sure it is correct or the way it should be
Danger  - the possibility that someone or something will be harmed or killed, or that something bad will happen
Department - a part of an organization such as a school, business or government which deals with a particular area of study or work
Earring - a piece of jewellery that you wear on or through your ear
Enough - as much as is necessary
Fantastic - extremely good
Finger - one of the long thin separate parts of the hand, including your thumb
Gift - a present or something which is given
Gram - a unit of mass equal to 0.001 kilograms
Happy - satisfied and not worried
Hockey - a team game played on grass where you hit a small ball with a long, curved stick
Immediately - now or without waiting or thinking about something
Insect - 	a small creature with six legs, for example a bee or a fly
Jewellery - objects made from gold, silver, and valuable stones that you wear for decoration
Jumper - a piece of clothing usually made of wool which covers the top of your body and is pulled on over your head
Kill - to cause someone or something to die
Kite - a toy made from paper or cloth which flies in the air on a long string
Laptop - a computer that is small enough to be carried around and used where you are sitting
Leather - the skin of animals that is used to make things such as shoes and bags
Mango - a tropical fruit that has a green skin and is orange inside
Motorbike - a vehicle with two wheels and an engine
Necklace - a piece of jewellery that you wear around your neck
Nurse - someone whose job is to care for ill and injured people
Offer - to say that you are willing to do something
Outside - not in a particular room or building but near it
Paint - to cover a surface with paint in order to decorate it
Platform - the area in a railway station where you get on and off trains
Quickly - at a fast speed
Quiz - a game or competition in which you answer questions
Racket - a net fixed tightly to an oval frame with a long handle, used in various sports for hitting a ball
Rubber - a small object which is used to remove pencil marks from paper
Sailing - a sport using boats with sails
Sheet - a flat piece of paper/glass, etc
Theatre - a building with a stage where people go to watch plays
Tights - a piece of women's clothing made of very thin material that covers the legs and bottom
Uncle - the brother of your mother or father, or the husband of your aunt
Usually - in the way that most often happens
View - the things that you can see from a place
Volleyball - a game in which two teams use their hands to hit a ball over a net without allowing it to touch the ground
Warm - describes clothes and covers made of a material that keeps you warm
Win - to get the most points in a competition or game
Yet - up until now
Yogurt - a slightly sour, thick liquid made from milk with bacteria added to it, sometimes sweetened and with a fruit flavour added and sometimes eaten plain
Zero - the number 0