Acceptable - good enough
Advertise - to tell people about a product or service in newspapers, on television, on the Internet, etc
Benefit - something that helps you or gives you an advantage
Broccoli - a green vegetable with a thick stem
Calf - a young cow
Carry - to have something with you all the time
Deaf - unable to hear, either completely or partly
Diagram - a simple picture showing what something looks like or explaining something
Education - the process of teaching or learning in a school or college, or the knowledge that you get from this
Entertain - to keep a group of people interested or enjoying themselves- 
Fairly - more than average, but less than very
Final - the last in a series of games, races or competitions, usually the one in which the winner is chosen
Generation - all the people in a society or family who are approximately the same age
Gym - a building or room with equipment for doing exercises
Hardware - the physical and electronic parts of a computer, rather than the programs
Hurt - to cause emotional pain to someone
Immigration - the place where people's official documents are checked when they enter a country at an airport, port, border, etc
Ingredient - a food that is used with other foods in the preparation of a particular dish
Joke - something which someone says to make people laugh, usually a short story with a funny ending
Jungle - a tropical forest in which trees and plants grow very closely together
Keen - very interested or enthusiastic
Knowledge - information and understanding that you have in your mind
Lady - a polite or old fashioned way of referring to or talking to a woman
Leave - to end a relationship with a husband, wife, or partner and stop living with them
Male - belonging to or relating to the sex that cannot have babies
Method - a way of doing something, often one that involves a system or plan
Narrow - narrow things measure a small distance from one side to the other
Number - an amount
Oil - a thick liquid that comes from under the Earth's surface that is used as a fuel and for making parts of machines move easily
Ordinary - not special, different, or unusual in any way
Owner - someone who owns something
Paragraph - a part of a text that usually contains several sentences and begins on a new line
Permanent - lasting or continuing for a long time or forever
Plain - simple and not complicated
Qualification - something that you get when you are successful in an exam or course of study
Quietly - making little or no noise
Rainforest - a forest in a tropical area which receives a lot of rain
Recognize - to know someone or something because you have seen, heard or experienced them before
Sailor - someone who sails ships or boats as their job or as a sport
Shock - a big, unpleasant surprise
Takeaway - a meal that you buy in a restaurant or shop but eat at home, or a shop that sells this type of meal
Tissue - a soft piece of paper that you use for cleaning your nose
Underpants - a piece of underwear that covers the area between your waist and the top of your legs
Unit - a single thing or a separate part of something larger
Van - a vehicle that is used for carrying things but which is smaller than a truck
Vowel - a speech sound that you make with your lips and teeth open, shown in English by the letters a, e, i, o, or u
Warning -something that tells or shows you that something bad may happen
Wheelchair - a chair with wheels used by someone who cannot walk
Yard - a unit of measurement equal to three feet or approximately 91.4 centimetres
Youth - young people generally
Zone - an area where a particular thing happens, that is used for a particular purpose, or where there are particular rules