Abandoned - left empty or not working
Accuracy - how correct or exact something is
Badge - a piece of metal, plastic, etc., with words or a picture on it which you wear on your clothes
Boast - to talk with too much pride about what you have done or what you own
Calculate - to discover an amount or number using mathematics
Chew - to crush food into smaller, softer pieces with the teeth so that it can be swallowed
Darling - used when you speak to someone you love or like
Decorative - made to look attractive
Eager - wanting to do or have something very much
Expectation - when you expect good things to happen in the future
Factor - one of the things that has an effect on a situation, decision, event, etc
Fire - to cause a weapon to shoot bullets, arrows or missiles
Gaze - to look for a long time at something or someone or in a particular direction
Greatness - skill and importance
Hammer - a tool with a heavy, metal part at the top that you use to hit nails into something
Hint - when you say something that suggests what you think or want, but not in a direct way
Illness - when you are ill
Immoral - morally wrong
Jam - a line of cars, trucks, etc. that are moving slowly or not moving
Justify - to give or to be a good reason for
Key - one of the parts that you press with your fingers on a computer or musical instrument to produce letters, numbers, symbols or musical notes
Kneel - to go down into, or stay in, a position where one or both knees are on the ground
Lack - to not have or not have enough of something that is needed or wanted
Latter - near or towards the end of something
Magical - with special powers
Management - the control and organization of something
Natural - normal or expected
Note - a short explanation or an extra piece of information that is given at the bottom of a page or at the back of a book
Obey - to do what you are told to do by a person, rule, or instruction
Odd - strange or unusual
Pale - If your face is pale, it has less colour than usual because you are ill or frightened
Pedal - a part of a machine that you press with your foot to operate or move the machine
Plot - the story of a book, film, play, etc
Queue - to wait in a line of people, often to buy something
Quite - almost but not completely
Range â€“ the amount or number between a particular set of limits
Raw - in the natural state
Readily - quickly and easily
Satellite - a piece of equipment that is sent into space around the Earth to receive and send signals or to collect information
Script - the words written for and spoken in a film, play, broadcast or speech
Tan - when your skin is brown from being in the sun
Terms - the rules of an agreement
Unacceptable - too bad to be allowed to continue
Unconscious - in a state as though you are sleeping, for example because you have been hit on the head
Valid - based on good reasons or facts that are true
Varied  - consisting of many different things or types
Wander - to walk around slowly in a relaxed way or without any clear purpose or direction
Wealth - a large amount of money or valuable possessions that someone has
X-ray - a photograph that shows the inside of your body
Yacht - a boat with sails and sometimes an engine, used for either racing or travelling on for pleasure
Yawn - to take a deep breath with your mouth wide open, because you are tired or bored