Adult - a person or animal that has grown to full size and strength
Answer - what you say or write back to someone who has asked you a question or spoken to you
Ball -  a round object that you throw, kick, or hit in a game, or something with this shape
Bathroom - a room with a bath and/or shower and often a toilet
Camera - a device for taking photographs or making films or television programmes
Chair - a seat for one person, which has a back, usually four legs, and sometimes two arms
Dance - to move your feet and body to the rhythm of music
Eat - to put food into your mouth and then swallow it
Enjoy - to get pleasure from something
Face - the front part of the head, where the eyes, nose and mouth are, or the expression on this part
Fat - someone who is fat weighs too much.
Glass - a hard transparent substance that objects such as windows and bottles are made of
Grass - a common plant with narrow green leaves that grows close to the ground
Home - the place where you live or feel you belong
Horse - a large animal with four legs, which people ride on or use for carrying things or pulling vehicles
Interesting - someone or some--thing that is interesting keeps your attention because they are unusual, exciting, or have a lot of ideas.
Juice - the liquid that comes from fruit or vegetables
Kitchen - a room where food is kept, prepared and cooked and where the dishes are washed
Know - to have knowledge or information about something in your mind
Language - a type of communication used by the people of a particular country
Listen - to give attention to someone or something in order to hear them
Meet - to see and speak to someone for the first time
Museum - a building where you can look at important objects connected with art, history, or science
Near - close in distance
Newspaper - large, folded sheets of paper which are printed with the news and sold every day or every week
Often - many times or regularly
Orange - being a colour that is a mixture of red and yellow
Page - a piece of paper in a book, magazine, etc., or one side of a piece of paper
Pen - a long, thin object that you use to write or draw in ink
Quarter - a period of 15 minutes before or after the hour
Question - a sentence or phrase used to find out information
Radio - a piece of equipment used for listening to radio broadcasts
Remember - if you remember a fact or something from the past, you keep it in your mind, or bring it back into your mind.
Sad - unhappy or making you feel unhappy
Short - small in length, distance or height
Talk - to say things to someone
Tennis - a sport in which two or four people hit a small ball to each other over a net
University - a place where students study at a high level to get a degree
Until - continuing to happen before a particular time or event and then stopping
Visit - to go to someone's home and spend time with them
Village - a place where people live in the countryside that includes buildings such as shops but is smaller than a town
Waitress - a woman who works in a restaurant, bringing food to customers
Want - to hope to have or do something, or to wish for something
Watch - to look at something for a period of time
Weather - the conditions in the air above the Earth such as wind, rain or temperature, especially at a particular time over a particular area
Year - a period of twelve months, especially from January 1st to December 31st
You - used to refer to the person or people you are talking to
Young - having lived or existed for only a short time and not old
Zoo - a place where wild animals are kept so that people can go and look at them
